1000000001
1100000011
1010000101
1001001001
1000110001
1000000001