1111001111
1111111111
1001001001
1111111111
0000110000
0000110000
1111001111
1001001001
1111111111
1111001111