0000110000
0001001000
0010000100
0111111110
1000000001
1000000001