1100000001
1010000001
1001000001
1000100001
1000010001
1000001001
1000000101
1000000011