1111111111
1010110101
1010110101
1010110101
1010110101
1010110101
1010110101
1111111111