1111111111
1110000001
1111110001
1111111001
1001111111
1000111111
1000000111
1111111111