1010101001
0101010010
1010100101
0101001010
1010010101
0100101010
1001010101
0010101010