1111001111
1001001001
1001001001
1111001111
0000000000
0000000000
1111001111
1001001001
1001001001
1111001111